dented	abollado
ludicrous	ridículo
betrays	traiciona
revengeful	vengativo
disagreeable	desagradable
entrust	confiar
aspersion	aspersión
overture	obertura
diligently	diligentemente
deprecate	desaprobar
enrapture	arrebatar
sadden	entristecer
time-honored	tradicional
commotion	conmoción
fabrication	fabricación
jaded	hastiado
smut	tizón
stumble	tropezón
absence	ausencia
despoiler	despojador
greatest	mayor
well	bien
invader	invasor
poisonously	venenosamente
extremists	extremistas
