randomly	azar
eye-catch	ojo-captura
martyrdom	martirio
disrespectful	irrespetuoso
shortcoming	defecto
idiots	idiotas
overacted	sobreactuado
dull	aburrido
cruelty	crueldad
idiocies	idioteces
jam	mermelada
fabulously	fabulosamente
impropriety	impropiedad
spade	pala
refuses	niega
reconciliation	reconciliación
sullen	hosco
unnatural	antinatural
awkward	incómodo
draconian	draconiana
ecstasies	éxtasis
outstanding	sobresaliente
disastrously	desastrosamente
insubstantial	insubstancial
prestige	prestigio
wail	gemido
tarnished	empañado
smiling	sonriente
satisfying	satisfactorio
unwarranted	injustificado
sparkle	brillo
harmoniously	armoniosamente
evasive	evasivo
covenant	pacto
improving	mejorar
sensational	sensacional
bizarre	extraño
expropriation	expropiación
hug	abrazo
betrayal	traición
wretched	miserable
pestilent	pernicioso
goodness	bondad
protest	protesta
prevaricate	prevaricar
aches	dolores
hangs	cuelga
peace	paz
manipulate	manipular
false	falso
precipitous	escarpado
catchy	pegadizo
blunt	embotado
pretense	pretensión
adored	adorado
bumping	chocar
caustic	cáustico
scandalous	escandaloso
relapse	recaída
scoundrel	canalla
misgivings	recelos
undersized	insuficiente
lone	solitario
soapy	jabonoso
flutter	aleteo
renown	renombre
weird	extraño
ready	listo
mind-blowing	alucinante
incognizant	ignorante
baffling	desconcertante
overwhelmingly	abrumadoramente
accolades	reconocimientos
adore	adorar
deficient	deficiente
breeze	brisa
robust	robusto
jealous	celoso
occlude	ocluir
measly	miserable
excuse	excusa
friggin	puto
clash	choque
atrocity	atrocidades
desolately	tristemente
praising	alabando
outsmart	burlar
inhuman	inhumano
bountiful	abundante
enticingly	seductoramente
oppression	opresión
brand-new	flamante
pervert	pervertido
averse	contrario
insignificantly	insignificantemente
cracks	grietas
embarrassing	embarazoso
favored	favorecido
available	disponible
awfully	terriblemente
unachievable	inalcanzable
anti-white	anti-blanco
sneaky	furtivo
graciously	graciosamente
blissfully	felizmente
infallibility	infalibilidad
incendiary	incendiario
filth	inmundicia
risks	riesgos
fortitude	fortaleza
flimsy	endeble
gratify	satisfacer
uncompromising	intransigente
nastiness	suciedad
fascinating	fascinante
idiocy	idiotez
filthy	inmundo
protection	protección
pedantic	pedante
poisonous	nocivo
incorrect	incorrecto
congratulatory	congratulatorio
illiterate	analfabeto
indignant	indignado
frets	trastes
noxious	nocivo
rusty	oxidado
unfinished	inconcluso
alienated	alienado
permissible	permisible
preferable	preferible
plague	plaga
renaissance	renacimiento
drains	desagües
symptoms	síntomas
doubts	dudas
discontinued	discontinuado
gnawing	roer
immature	inmaduro
reputable	acreditado
sabotage	sabotaje
timidly	timidez
convincingly	convincentemente
splendid	espléndido
fine	fino
breathlessness	disnea
lurch	estacada
marvels	maravillas
marveled	maravillado
enthusiastic	entusiasta
prisoner	prisionero
quarrels	peleas
intermittent	intermitente
cocky	gallito
lousy	piojoso
assail	atacar
subversion	subversión
peeled	pelado
autocratic	autocrático
intrusion	intrusión
confessions	confesiones
mistake	error
noisy	ruidoso
stifling	sofocante
presumptuous	presuntuoso
rectify	rectificar
polished	pulido
snappishly	brusquedad
winner	ganador
excoriate	excoriar
scolding	regaño
stressful	estresante
unselfish	altruista
assure	asegurar
humming	zumbador
maladjustment	inadaptación
inopportune	inoportuno
helped	ayudado
drips	goteos
frenetic	frenético
humble	humilde
balk	obstáculo
ignominiously	ignominiosamente
unthinkable	inconcebible
insufferably	insufriblemente
solemn	solemne
two-faced	hipócrita
progress	progreso
disadvantaged	perjudicado
defect	defecto
swelling	hinchazón
dominates	domina
economical	económico
retaliatory	vengativo
repress	reprimir
ease	facilidad
shirker	gandul
washed-out	desteñido
impeccable	impecable
poeticize	poetizar
salacious	salaz
melodramatic	melodramático
rejects	rechaza
effusively	efusivamente
rapt	absorto
demonize	demonizar
stunning	maravilloso
rapid	rápido
brilliantly	brillantemente
phony	falso
detraction	detracción
cramping	calambres
smiles	sonrisas
blurs	desenfoques
crept	deslizado
desperation	desesperación
blindingly	cegador
witty	ingenioso
disintegrated	desintegrado
distraught	loco
flares	bengalas
fallaciousness	falacia
dread	temer
irritation	irritación
craven	cobarde
exalting	exaltando
uncivil	incivil
strikingly	sorprendentemente
delusion	ilusión
charisma	carisma
fret	traste
dazed	aturdido
lie	mentira
indifferent	indifférent
terrifically	estupendamente
panic	pánico
tempting	tentador
worsening	empeoramiento
infuriate	enfurecer
tawdry	cursi
radically	radicalmente
paradoxical	paradójico
devil	diablo
failures	fracasos
accost	abordar
dismissive	desdeñoso
acerbate	exacerbar
stimulate	estimular
inefficiency	ineficacia
incapable	incapaz
involuntary	involuntario
ineffectually	ineficazmente
prodigious	prodigioso
recessionary	recesivo
stalemate	estancamiento
remorselessness	implacabilidad
bravado	bravata
gabble	parloteo
gainsay	contradecir
instigate	instigar
timid	tímido
unreal	irreal
assurance	garantía
congratulation	felicitación
delicacy	delicadeza
complaints	quejas
helping	ayudar
break-ups	rupturas
brood	cría
blockbuster	superproducción
radiant	radiante
scrambling	aleatorización
fastidious	fastidioso
fall	caer
mischievous	travieso
reclaim	reclamar
tingle	hormigueo
dubiously	dudosamente
easiness	facilidad
well-mannered	educado
plot	parcela
swift	rápido
inefficient	ineficiente
back-woods	back-maderas
feat	hazaña
tantalizing	tentadora
negligent	negligente
spurious	espurio
award	premio
stimulates	estimula
ebullience	entusiasmo
extermination	exterminio
enraged	enfurecido
criticized	criticado
blunders	errores
failing	defecto
bully	matón
terrorize	aterrorizar
diametrically	diametralmente
fustigate	fustigar
perseverance	perseverancia
obnoxious	desagradable
wrangle	reñir
solicitude	solicitud
contention	contención
mischief	travesura
idyllic	idílico
traumatically	traumáticamente
vanity	vanidad
rightfully	legítimamente
distressing	angustioso
forlorn	abandonado
securely	segura
spoiled	estropeado
fleeing	huyendo
excels	sobresale
anxieties	ansiedades
improve	mejorar
vibrantly	vibrantemente
ail	afligir
outperform	superan
shemale	transexual
mad	loco
begging	mendicidad
moan	gemido
glitz	brillo
dripping	goteo
workable	factible
squealing	chillido
insensitive	insensible
fever	fiebre
grievances	quejas
obstacle	obstáculo
intoxicate	intoxicar
galling	mortificante
efficacious	eficaz
gracefully	graciosamente
awkwardness	torpeza
stutters	tartamudea
sugar-coat	endulzar
inexperienced	despistados
dishonesty	deshonestidad
fatuously	fatuamente
unwavering	inquebrantable
downside	desventaja
perish	perecer
blessing	bendición
fuss	bulla
wisdom	sabiduría
titillating	excitante
untruthful	mentiroso
exceed	exceder
impiety	impiedad
meanness	mezquindad
refine	refinar
strenuous	agotador
overtaxed	sobrecargado
effectual	eficaz
bungler	chapucero
shrill	estridente
jeers	burlas
supurbly	increíblemente
tainted	contaminado
nebulously	vagamente
reverence	reverencia
cherished	querido
cliche	cliché
regret	lamentar
powerless	impotente
haunt	rondar
stole	estola
catastrophically	catastróficamente
dirts	suciedades
indiscreetly	indiscretamente
scandals	escándalos
lack	falta
wrest	arrebatar
lewdly	lascivamente
noteworthy	notable
inadequately	inadecuadamente
loot	botín
irredeemable	irredimible
prestigious	prestigioso
bloated	hinchado
genius	genio
disapprobation	desaprobación
ailing	enfermo
prideful	orgulloso
grand	magnífico
coldly	fríamente
hotbeds	semilleros
faithful	fiel
defeating	derrotar
dastardly	ruin
aspiration	aspiración
lags	desfases
depression	depresión
scrambles	revuelve
stink	hedor
humiliate	humillar
forbidden	prohibido
gruesomely	horriblemente
unrelentingly	implacablemente
exceptional	excepcional
contemptuously	desdeñosamente
cleaner	limpiador
avenge	vengar
perplexity	perplejidad
prudent	prudente
watered-down	aguada
wonderfully	maravillosamente
anxious	ansioso
praiseworthy	loable
wowing	sorprendente
steals	robos
thwart	frustrar
regrettable	lamentable
disillusions	desilusiones
readily	fácilmente
limited	limitado
outshone	eclipsó
revolutionizes	revoluciona
spacious	espacioso
entangle	enredar
glare	deslumbramiento
delighted	encantado
unhappily	infelizmente
stubborn	obstinado
awesomely	impresionantemente
hostage	rehén
adequate	adecuado
cleanly	limpiamente
troublemaker	alborotador
civilize	civilizar
fucking	jodido
lighter	encendedor
diabolical	diabólico
buggy	calesa
acrimony	acritud
insurmountably	insuperablemente
pleasingly	agradablemente
vileness	vileza
petrified	petrificado
illogically	ilógicamente
conflicts	conflictos
qualm	náusea
lengthy	largo
plight	situación
striving	esfuerzos
delirious	delirante
toxic	tóxico
mashed	puré
persevere	perseverar
syndrome	síndrome
gold	oro
weak	débil
melodramatically	melodramáticamente
endorses	respalda
irrational	irracional
ominous	siniestro
refuting	refuta
muddle	embrollo
disruption	trastorno
anxiousness	ansiedad
hang	caída
nourishment	alimento
pickets	piquetes
offending	infractor
adverse	adverso
confusion	confusión
hypocritically	hipócritamente
dependable	confiable
disconcerting	desconcertante
dignified	digno
elate	regocijado
dogged	obstinado
unfavorable	desfavorable
ineligible	inelegible
subjection	sujeción
stodgy	pesado
quiet	tranquilo
positive	positivo
poised	listo
incomplete	incompleto
adversary	adversario
satisfied	satisfecho
quack	charlatán
realistic	realista
little	poco
welcome	bienvenida
versatility	versatilidad
maniacal	maníaco
complaining	quejarse
uneasily	inquieto
daringly	atrevidamente
obscures	oscurece
regressive	regresivo
revolting	repugnante
effectiveness	efectividad
effusive	efusivo
bothersome	molesto
contaminates	contaminantes
ardently	ardientemente
receptive	receptivo
decrepit	decrépito
adulterate	adulterar
avidly	ávidamente
pain	dolor
benevolence	benevolencia
tenderly	ternura
hamper	estorbar
tortured	torturado
privilege	privilegio
deaf	sordo
humorous	humor
grandeur	grandeza
sweet	dulce
bleeding	sangrado
greedy	codicioso
maniac	maníaco
murder	asesinato
unwieldy	pesado
fondness	afición
imprecision	imprecisión
gained	ganado
combative	combativo
desolation	soledad
outburst	explosión
dearth	escasez
ached	dolía
extraordinarily	extraordinariamente
err	errar
famished	famélico
nauseate	repugnar
disapproving	desaprobación
illustrious	ilustre
faltered	tambaleado
-	-
unsettlingly	perturbadoramente
intimidating	intimidante
naughty	travieso
proficient	competente
supporter	partidario
confident	confiado
underlings	subordinados
havoc	estragos
immovable	inamovible
insulted	insultado
harmonious	armonioso
humid	húmedo
brutalize	embrutecer
overweight	sobrepeso
nepotism	nepotismo
sunken	hundido
unresolved	irresoluto
petrify	petrificar
fruitlessly	infructuosamente
tedious	tedioso
darken	oscuro
virtuous	virtuoso
stringent	riguroso
unspeakable	indecible
disasterous	desastroso
wow	sorprender
happily	felizmente
imaginative	imaginativo
insinuating	insinuante
misleading	engañoso
horrendous	horrendo
recession	recesión
messes	líos
impassioned	apasionado
sincerity	sinceridad
untrue	falso
controversy	controversia
knock	llamar
imbecile	imbécil
suave	afable
mightily	poderosamente
taunt	pulla
partiality	parcialidad
refuted	refutado
piety	piedad
massacre	matanza
weaken	débil
patronize	patrocinar
menial	servil
bashful	tímido
awesome	impresionante
deride	ridiculizar
susceptible	probablemente
jeeringly	burlonamente
entice	atraer
despondently	desaliento
suffices	suficiente
enchant	encantar
hysterical	histérico
dissatisfaction	insatisfacción
foulness	asquerosidad
disagreeing	desacuerdo
gloomy	triste
puppets	marionetas
fissures	fisuras
ineptitude	ineptitud
unbeatable	insuperable
condemns	condena
prefers	prefiere
inhibit	inhibir
discourage	desalentar
aggressive	agresivo
niggle	queja
ideally	idealmente
chronic	crónico
ruin	ruina
despoil	despojar
irony	ironía
admonish	amonestar
treacherous	traicionero
tamper	antisabotaje
sickness	enfermedad
absentee	ausente
conspiracies	conspiraciones
handicapped	discapacitados
refunded	reintegrado
inarticulate	inarticulado
disloyal	desleal
cheat	engañar
niggles	peros
damn	maldito
really	realmente
shamelessly	desvergonzadamente
sweeten	dulce
mysterious	misterioso
disagreement	desacuerdo
exult	exultar
enterprising	emprendedor
bothers	molesta
fortune	fortuna
incommensurate	inconmensurable
luckier	suerte
rewardingly	recompensadoramente
intelligent	inteligente
easygoing	acomodadizo
better	mejor
abrupt	abrupto
outrageously	atrozmente
coherence	coherencia
dungeons	mazmorras
adulatory	adulador
undermines	socava
mistaken	equivocado
excuses	excusas
stylishly	elegantemente
vexing	irritante
extremely	extremadamente
drunken	borracho
illuminate	iluminar
apathetic	apático
conflict	conflicto
enthuse	entusiasmar
sarcastically	sarcásticamente
steadfastly	firmemente
pampers	mima
skillful	hábil
competitive	competitivo
jolt	sacudida
hysteria	histeria
beg	mendigar
worse	peor
enough	suficiente
drowning	ahogo
unusably	inutilizable
undermine	minar
egomania	egomanía
heartbreaking	angustioso
inability	incapacidad
recommendation	recomendación
daunting	desalentadora
recovery	recuperación
cramp	calambre
wretch	desgraciado
subservient	subordinado
repudiate	repudiar
bad	malo
misbegotten	bastardo
fascinatingly	fascinantemente
self-serving	auto-servicio
classic	clásico
benefits	beneficios
irk	fastidiar
quibble	sutileza
savage	salvaje
straightforward	sencillo
gibber	farfullar
miss	señorita
aggressiveness	agresividad
simplifies	simplifica
incivility	incivilidad
complain	quejarse
admiringly	admirativamente
profoundly	profundamente
overbearing	imperioso
longingly	añoranza
impudently	impudentemente
abysmally	abismalmente
prodigiously	prodigiosamente
destroyer	destructor
apprehensive	aprensivo
rough	áspero
neurotically	neuróticamente
nonexistent	inexistente
engrossing	absorbente
gloom	penumbra
sloppily	descuidadamente
ingenious	ingenioso
subjugate	subyugar
fragrant	fragante
sad	triste
bitterness	amargura
loopholes	lagunas
disingenuous	falso
inconsiderate	desconsiderado
nemesis	justicia
imaculate	impecable
wows	sorpresas
devout	devoto
flawed	defectuoso
debility	debilidad
lonesome	solitario
easing	aliviando
pamperedly	mimado
lying	acostado
self-sufficiency	autosuficiencia
fevers	fiebres
importunate	importuno
trivialize	trivializar
scowl	ceño
licentiousness	libertinaje
goodly	hermoso
chafe	rozar
overblown	marchito
amazing	asombroso
rebuff	rechazo
positives	positivos
heartwarming	reconfortante
snappy	rápido
restlessness	inquietud
shrilly	estridente
panoramic	panorámico
thrilling	electrizante
ghastly	horrible
gimmicks	trucos
dissolution	disolución
could	podía
thirst	sed
stew	estofado
gleeful	jubiloso
profound	profundo
stupendously	estupendamente
intuitive	intuitivo
earnestly	formalmente
blameless	irreprochable
puzzled	perplejo
distrusting	desconfiando
valiant	valiente
faze	perturbar
startling	asombroso
admiration	admiración
stylish	elegante
adulterated	adulterada
imbalance	desequilibrio
shatter	destrozar
quaint	pintoresco
crash	choque
erroneously	erróneamente
shun	rehuir
flickers	parpadeos
silent	silencioso
outraged	indignados
pique	piqué
imperfect	imperfecto
unnerving	enervante
knife	cuchillo
ambitious	ambicioso
obliterated	obliterado
shimmering	reluciente
uphold	defender
troublesome	molesto
ferociously	ferozmente
refinement	refinamiento
incoherently	incoherentemente
wariness	cautela
dismayingly	desalentadoramente
fascination	fascinación
disgruntled	descontento
infuriated	enfurecido
hegemony	hegemonía
din	estruendo
irresponsibly	irresponsable
destruction	destrucción
infraction	infracción
negative	negativo
outbreak	brote
humiliating	humillante
wretchedness	miseria
pretentiously	pretenciosamente
insincerity	insinceridad
rational	racional
reconcile	reconciliar
limitations	limitaciones
anemic	anémico
dusty	polvoriento
nebulous	nebuloso
isolation	aislamiento
mortified	mortificado
damaging	perjudicial
outbursts	arrebatos
inflated	inflado
poise	porte
outperforms	supera
calumniously	calumniosa
oversimplification	sobresimplificación
sack	saco
assassin	asesino
disappointingly	decepcionantemente
fundamentalism	fundamentalismo
distraction	distracción
decadent	decadente
amazingly	asombrosamente
puzzling	misterioso
immobilized	inmovilizado
viper	víbora
peril	peligro
enhance	mejorar
noise	ruido
brisk	enérgico
unobserved	desapercibido
affordable	asequible
pessimism	pesimismo
brutally	brutalmente
repetitive	repetitivo
oblique	oblicuo
restored	restaurada
commotions	conmociones
pleasurably	agradablemente
torturing	tortura
harmony	armonía
enough	suficiente
abundant	abundar
procrastinates	posterga
rejoice	alegrarse
privileged	privilegiado
impolitic	impolítico
unforeseen	contingencias
fruitless	infructuoso
pugnacity	pugnacidad
refresh	refrescar
heartbreaker	rompecorazones
counter-attacks	contraataques
intriguing	secreto
glut	superabundancia
hard-working	trabajador
discourteous	descortés
charming	encantador
conceit	presunción
perilous	peligroso
inaccuracies	inexactitudes
didn't	no
mischievously	maliciosamente
acclaim	aclamación
cuss	maldecir
won't	no
fist	puño
renounce	renunciar
hazard	peligro
dishearteningly	descorazonadoramente
frustrations	frustraciones
relentlessly	implacablemente
zealot	fanático
fulminate	fulminar
conciliatory	conciliador
sickeningly	repugnantemente
pleasurable	placentero
dazzled	deslumbrado
betrayals	traiciones
unsteady	inestable
dangerous	peligroso
effrontery	descaro
exciting	emocionante
tentative	tentativo
disapointed	decepcionado
lividly	lívidamente
annoyance	molestia
insatiable	insaciable
worry	preocuparse
infamous	infame
bust	busto
impure	impuro
foresight	previsión
distrust	desconfianza
thank	agradecer
loss	pérdida
uproarious	estruendoso
wiles	engaños
wrongly	erróneamente
outperforming	superando
remarkable	notable
hinder	dificultar
scorching	abrasador
flashy	ostentoso
languid	lánguido
lag	retraso
disappoint	decepcionar
grim	severo
beautify	embellecer
decrement	decremento
extravagance	extravagancia
spookier	fantasmagóricos
rumbling	retumbante
enrich	enriquecer
motley	abigarrado
vague	vago
harrow	grada
livid	lívido
comical	cómico
joyfully	alegremente
temptation	tentación
bastard	bastardo
inattentive	inatento
lacked	carecido
sly	astuto
sidetrack	apartadero
sensible	sensato
glorious	glorioso
patiently	pacientemente
scare	susto
endorsement	endoso
rejuvenate	rejuvenecer
flee	huir
lumpy	grumoso
encroach	usurpar
passionate	apasionado
stern	popa
spontaneous	natural
fortunate	afortunado
provocation	excitación
obsolete	obsoleto
evocative	evocador
achievements	logros
outmoded	anticuado
barbarian	bárbaro
vainly	vanamente
enhanced	mejorado
improper	impropio
harangue	arenga
restful	sosegado
fool	engañar
preposterous	absurdo
nurturing	crianza
merriness	alegría
undaunted	impávido
decisiveness	decisión
resentful	resentido
cushy	cómodo
assuredly	ciertamente
scathingly	mordazmente
urgent	urgente
laughingstock	hazmerreír
nourishing	nutritiva
exonerate	exonerar
pervasive	penetrante
smug	presumido
agreeable	agradable
glitter	purpurina
mercy	misericordia
succes	éxito
pleasure	placer
declining	declinante
secure	asegurar
tease	embromar
capitulate	capitular
carnage	carnicería
crumples	arruga
punitive	punitivo
ambivalent	ambivalente
tricky	difícil
distort	distorsionar
woo	cortejar
prate	prateek
excessively	excesivamente
demeaning	degradante
miseries	miserias
poignant	conmovedor
fanaticism	fanatismo
contradict	contador
egotistically	egoístamente
misfit	inadaptado
youthful	juvenil
agilely	ágilmente
protect	proteger
pampered	mimado
insolence	insolencia
inconvenience	inconveniencia
generous	generoso
gaffe	patinazo
tentatively	tentativamente
massacres	masacres
haughty	altivo
compulsion	compulsión
slaughtered	sacrificados
clog	zueco
savvy	comprensión
beutifully	hermosamente
underestimate	subestimar
sagged	combado
alarm	alarma
disrupt	interrumpir
wildly	salvajemente
wretchedly	miserablemente
antipathy	antipatía
meltdown	crisis
critical	crítico
dashing	gallardo
disturbance	perturbación
best	mejor
indoctrinate	adoctrinar
ultimatums	ultimátums
wrath	ira
knowledgeable	experto
travesty	parodia
romantic	romántico
disagreeably	desagradablemente
devastate	devastar
rigidity	rigidez
disavow	desautorizar
complement	complemento
unreadable	ilegible
outlaw	proscribir
free	gratis
squeaky	chirriante
saintliness	santidad
saint	santo
spectacularly	espectacularmente
imprison	aprisionar
fiend	demonio
dissemble	disimular
hustler	estafador
supreme	supremo
gladness	alegría
crazily	locamente
exasperated	exasperada
jaundiced	ictérico
congratulate	felicitar
confound	confundir
disarm	desarmar
censure	censura
enjoy	disfrutar
allege	alegar
fervently	fervorosamente
disgusting	repugnante
unquestionably	incuestionablemente
irrelevant	irrelevante
bombard	bombardear
pry	palanca
profusion	profusión
berate	regañarse
whining	gimoteo
foul	falta
humour	humor
exorbitant	exorbitante
exhorbitant	exorbitante
sputter	chisporroteo
upheaval	convulsión
unlawfulness	ilegalidad
myth	mito
fuzzy	borroso
vindictively	vengativamente
paucity	escasez
deteriorating	deterioro
calamity	calamidad
distressingly	penosamente
laid-off	despedidos
atrocious	atroz
stealing	robo
gibberish	algarabía
zaps	zapping
consistently	consecuentemente
obstinate	obstinado
proving	prueba
imminence	inminencia
unsuccessful	infructuoso
abolish	abolir
enthusiast	entusiasta
trap	trampa
harpy	arpía
illusions	ilusiones
plunderer	saqueador
rivalry	rivalidad
pokey	diminuto
barbarity	barbarie
smear	frotis
sorrowful	triste
disastrous	desastroso
ill-fated	malogrado
allergic	alérgico
awfully	terriblemente
upgradable	actualizable
tenacity	tenacidad
gleefully	alegremente
ungrateful	ingrato
complimentary	cortesía
irreproachable	irreprochable
breakthroughs	avances
recommend	recomendar
frictions	fricciones
traduce	difamar
affront	afrenta
oversight	vigilancia
venom	veneno
fiery	ardiente
enjoyable	agradable
hail	granizo
inferiority	inferioridad
scorchingly	abrasadoramente
burn	quemar
rude	grosero
perversely	perversamente
irrationally	irracionalmente
incoherent	incoherente
spurn	desdeñar
perversity	perversidad
gentle	suave
aggrieved	agraviado
counter-attack	contraataque
fairly	bastante
lucidly	lúcidamente
limit	límite
imperfection	imperfección
soreness	dolor
inhumanity	inhumanidad
impede	impedir
strangely	extrañamente
nefarious	vil
snarl	gruñido
unprepared	desprevenido
crafty	astuto
offensive	ofensiva
kindliness	bondad
muddy	fangoso
nice	agradable
remarkably	extraordinariamente
pleas	súplicas
repulsive	repulsivo
enchanting	encantador
worst	peor
oddities	rarezas
obscure	oscuro
fume	humo
malevolent	malévolo
bruises	contusiones
drawback	inconveniente
scourge	azote
upscale	lujo
derisively	burlonamente
prosecute	procesar
respectable	respetable
purify	purificar
wounds	heridas
leaks	fugas
abuse	abuso
rue	ruda
detested	detestado
sleek	pulcro
stale	viciado
ailment	enfermedad
panick	pánico
prosper	prosperar
unresponsive	insensible
graceful	agraciado
enough	suficientemente
bereave	privar
bum	culo
curse	maldición
wobbles	bamboleos
messing	ensuciando
extort	extorsionar
self-sufficient	autosuficiente
rebuke	reprensión
heroic	heroico
elated	exaltado
oppress	oprimir
scenic	escénico
dwindling	menguante
empathy	empatía
naive	ingenuo
unconstitutional	inconstitucional
manic	maníaco
annihilation	aniquilación
unfazed	imperturbable
hooray	hurra
jittery	nervioso
blockage	obstrucción
opulent	opulento
saintly	santo
fatigue	fatiga
empower	autorizar
blemish	mancha
hypocrites	hipócritas
ecstatically	éxtasis
stately	majestuoso
pig	cerdo
hardship	privación
eventful	memorable
enough	bastantes
deter	disuadir
blah	bla
depressing	deprimente
progressive	progresivo
loathe	detestar
fearsome	temible
impotent	impotente
flaky	escamoso
costly	costoso
longing	anhelo
beauteous	hermoso
defiant	desafiante
caustically	cáusticamente
trophy	trofeo
electrify	electrizar
lackluster	deslucido
dependably	fiable
spewing	vomitando
frighteningly	pavorosamente
sloppy	descuidado
squander	tiempo
transgression	transgresión
mawkish	empalagoso
creeping	progresivo
rip-off	estafa
excited	excitado
admire	admirar
wealthy	rico
froze	congeló
willingness	disposición
maliciousness	malicia
squirm	retorcerse
delinquency	delincuencia
worth	valor
distasteful	desagradable
animosity	animosidad
very	mucho
repugnant	repugnante
nicely	bien
stifle	ahogar
venomous	venenoso
dragged	arrastrado
obtrusive	molesto
surreal	surrealista
repulsing	repeliendo
pretentious	pretencioso
liking	gusto
exultation	exultación
homage	homenaje
ravage	destrozar
protracted	prolongado
cloudy	nublado
anti-proliferation	anti-proliferación
swindle	estafa
acclaimed	aclamado
encouragingly	alentador
mislead	engañar
gratified	gratificado
superficially	superficialmente
stagnate	estancarse
reasoned	razonada
astutely	astutamente
ineffectively	ineficazmente
coerce	obligar
soulful	sentimental
trample	pisotear
slander	difamación
madden	enloquecer
relentlessness	implacabilidad
effortlessly	permitiendo
debilitating	debilitante
derisive	burlón
vomit	vómito
blinding	cegador
mesmerizes	hipnotiza
proud	orgulloso
reprehensive	reprensibles
indiscriminating	indiscriminada
confrontation	confrontación
guile	engaño
monstrously	monstruosamente
harmed	perjudicado
insulting	insultante
sensitive	sensible
hurt	daño
waste	residuos
oversights	descuidos
delusional	delirante
inhibition	inhibición
smudged	manchado
grieving	duelo
inhospitable	hostil
clean	limpio
painfully	penosamente
mistakes	errores
nourish	nutrir
sully	manchar
clumsy	torpe
uncollectible	incobrables
victimize	victimizar
danken	húmedo
satirical	satírico
bloody	sangriento
unnerved	enervado
banishment	destierro
insults	insultos
stench	hedor
revenge	venganza
bleakness	desolación
reformed	reformado
tempt	tentar
confuse	confuso
feint	finta
awestruck	atemorizado
unsatisfactory	insatisfactorio
incredibly	increíblemente
baffled	desconcertado
dissonantly	disonantemente
uplifting	inspirador
fabricate	fabricar
nefariously	vilmente
faint	débil
craftly	artesanalmente
contamination	contaminación
magic	magia
fluent	fluido
expel	expulsar
madness	locura
invaluable	inestimable
sticky	pegajoso
addicted	adicto
scold	regaño
malicious	malicioso
upset	trastorno
rape	violación
audaciousness	audacia
oddly	extrañamente
coarse	grueso
barbarously	bárbaramente
belittling	menosprecio
tempest	tempestad
flattering	halagüeño
snare	lazo
mockery	burlas
insightfully	perspicacia
spook	espectro
mocks	burla
abrade	desgastar
fickle	voluble
unimaginably	inimaginablemente
odor	olor
assuring	asegurando
butchery	carnicería
secretive	reservado
dark	oscuro
amply	ampliamente
imperiously	imperiosamente
top	superior
spitefulness	malevolencia
dissent	disidencia
denunciations	denuncias
fancier	criador
incitement	incitación
advocates	defensores
raving	delirio
spoil	estropear
endorsed	endosado
freakishly	monstruosamente
doggedly	tenazmente
revitalize	revitalizar
stupor	estupor
stingy	tacaño
praise	alabanza
proven	probado
tragedy	tragedia
snag	pega
boom	auge
rust	herrumbre
implicate	implicar
incomprehension	incomprensión
despicable	despreciable
caricature	caricatura
carp	carpa
ineffectualness	ineficacia
wondrous	maravilloso
encourage	fomentar
opposition	oposición
weary	cansado
intimidatingly	intimidantemente
impurity	impureza
disconcerted	desconcertado
mania	manía
envy	envidia
cancerous	canceroso
leakages	fugas
annoyed	irritado
erosion	erosión
plunder	saqueo
grudges	rencores
barren	bares
pamperedness	mimo
titillate	excitar
sacrificed	sacrificado
amenable	dócil
badly	mal
appalled	aterrado
procrastinate	aplazar
neglect	neglecta
bungling	torpeza
wrong	mal
rewarding	provechoso
disown	repudiar
improves	mejora
prudently	prudentemente
whiny	llorón
persecute	perseguir
complacent	complaciente
sweeping	general
criticizing	criticar
calumniate	calumniar
devastates	arrasa
farcical	absurdo
dauntingly	intimidantemente
unwilling	reacio
foremost	primero
overplay	exagerar
confess	confesar
dirty	sucio
overkill	exageración
repugnance	repugnancia
priceless	inestimable
contrasty	contrastada
confusions	confusiones
anti-american	antiamericano
indulgence	indulgencia
inexcusably	inexcusablemente
prejudices	prejuicios
sagging	hundimiento
heroically	heroicamente
hype	bombo
mourn	llorar
endorsing	endosar
fried	frito
fugitive	fugitivo
reactionary	reaccionario
adorer	adorador
judder	vibración
domineer	tiranizar
appropriate	apropiado
calmness	calma
slug	babosa
detracting	desmerecer
apocalyptic	apocalíptica
deceptive	engañoso
famous	famoso
ruinous	ruinoso
energize	energizar
disgracefully	vergonzosamente
brainless	estúpido
complicated	complicado
good	bueno
delight	deleite
irrationals	irracionales
talents	talentos
upheld	sostenida
insanely	locamente
defective	defectuoso
scarred	cicatrizado
severe	grave
should	debería
unyielding	inflexible
humiliation	humillación
reprimand	reprimenda
intriguingly	curiosamente
insolently	insolentemente
brutality	brutalidad
unruly	revoltoso
entertaining	entretenido
defiler	profanador
ferocity	ferocidad
smudge	mancha
disgust	asco
fans	ventiladores
grate	reja
merciless	despiadado
humility	humildad
blurry	borrosa
misalign	desalinear
abyss	abismo
ardent	ardiente
horrifies	horroriza
revulsion	repugnancia
bombastic	rimbombante
creeps	grima
cussed	terco
startlingly	sorprendentemente
insufferable	insufrible
excite	excitar
rascal	bribón
fatuous	fatuo
disconcertingly	desconcertantemente
dungeon	mazmorra
misunderstood	malinterpretado
self-destructive	autodestructivo
complaint	queja
fragile	frágil
contrived	artificial
breaking	rompiendo
negation	negación
capability	capacidad
reverent	reverente
marvel	maravilla
right	derecho
glimmering	resplandeciente
impending	inminente
displeasure	desagrado
rich	rico
comfortable	cómodo
imposing	colonial
frustrates	frustra
adjustable	ajustable
expertly	experta
divisiveness	divisionismo
variety	variedad
issue	cuestión
corrupts	corrompe
unity	unidad
steadfastness	firmeza
deprave	depravar
revolt	revuelta
stumps	tocones
inaction	inacción
prohibitive	prohibitivo
starkly	crudamente
whore	puta
gallant	galante
bullying	intimidación
condemn	condemi
jaw-droping	asombroso
foolhardy	temerario
offence	delito
clearly	claramente
profuse	liberal
unproductive	improductivo
disobedient	desobediente
pricey	caro
viewable	visible
embroilment	embrollo
sink	fregadero
proprietary	propietario
reckless	temerario
pre-eminent	preeminente
blockhead	alcornoque
grateful	agradecido
lewd	lascivo
tough	duro
ergonomical	ergonómico
facetious	chistoso
fatefully	fatídicamente
refutes	refuta
mendacity	mendacidad
preferring	prefiriendo
strict	estricto
abounds	abunda
sincerely	sinceramente
struggled	luchado
uneven	desigual
fidgety	nervioso
brutish	brutal
quash	anular
ultra-crisp	ultra-nítido
shroud	mortaja
ineffective	ineficaz
beloved	amado
pugnacious	pugnaz
blithe	alegre
felicitate	felicitar
overdo	exagerar
unrelenting	implacable
bitchy	perra
buzzing	zumbido
infirm	enfermizo
brazenly	descaradamente
insane	demente
bereavement	duelo
downcast	alicaído
revives	revive
confidence	confianza
acumen	perspicacia
sunk	hundido
threatening	amenazante
incorrigible	incorregible
subsidizes	subvenciona
lively	animado
obscenity	obscenidad
inappropriately	inapropiadamente
annihilate	aniquilar
epidemic	epidemia
merit	mérito
disruptive	disruptivo
sophisticated	sofisticado
maddeningly	exasperantemente
antagonistic	antagónico
reasonable	razonable
impetuously	impetuosamente
outshine	eclipsar
pander	alcahuete
haggle	regatear
unnerve	enervar
eminent	eminente
frightfully	espantosamente
delay	retraso
tepid	tibio
successes	éxitos
eulogize	elogiar
negativity	negatividad
irresponsible	impulsivo
vomited	vomitado
deference	deferencia
guarantee	garantía
illusory	ilusorio
rejuvenating	rejuvenecedor
browbeat	atemorizar
deceptively	engañosamente
disavowal	desautorización
simpler	sencillo
precisely	precisamente
beggar	mendigo
wonderously	maravillosamente
whine	silbido
rejection	rechazo
remorsefully	remordimiento
falter	desfallecer
killjoy	aguafiestas
offend	ofender
killer	asesino
damage	daño
throbbing	palpitante
luminous	luminoso
legendary	legendario
bogus	falso
worthiness	mérito
pitifully	lastimosamente
regrets	excusas
drastically	drásticamente
shabby	lamentable
luxuriate	deleitarse
hapless	desventurado
inanely	estúpidamente
diatribes	diatribas
tantalizingly	tentadoramente
deplorably	deplorablemente
harsh	áspero
marvelous	maravilloso
mocked	burlado
selective	selectivo
hate	odio
keenness	agudeza
illusion	espejismo
bias	parcialidad
frustrated	frustrado
indecently	indecentemente
racist	racista
inclement	inclemente
faults	fallas
disaccord	desacuerdo
losses	pérdidas
backbite	murmurar
scandalized	escandalizado
inadequacy	insuficiencia
undermined	minado
primitive	primitivo
enervate	enervar
advantageous	ventajoso
zest	entusiasmo
abound	abundar
embroil	embrollar
stigma	estigma
felicitous	feliz
bemoan	lamentar
succeed	éxito
hospitable	hospitalario
venomously	venenosamente
support	apoyo
ovation	ovación
sinister	siniestro
discomfort	dolor
deterioration	putrefacción
matchless	incomparable
fancy	fantasía
molestation	acoso
supporting	apoyando
appreciatively	apreciativa
evade	evadir
fictional	ficticio
demonizes	demoniza
jubilation	jubilación
dud	falso
emaciated	demacrado
stimulating	desafiante
paralyzed	paralizado
entrancing	fascinante
crowdedness	hacinamiento
authentic	auténtico
execrate	execrar
tormented	atormentado
jumpy	asustadizo
dishonest	deshonesto
energetic	energético
implication	implicación
bash	fiesta
excellence	excelencia
n't	no
wouldn't	no
strained	tenso
unlawful	ilegal
lustrous	lustroso
hallucination	alucinación
bane	perdición
enslave	esclavizar
gossip	chismes
blurred	borrosa
positively	afirmativamente
idiotic	idiota
inspirational	inspirado
grievance	queja
enjoin	ordenar
illness	enfermedad
isolated	aislado
unorthodoxy	heterodoxia
jubilant	jubiloso
disinterested	desinteresado
calamitous	calamitoso
slur	calumnia
enviably	envidiablemente
racists	racistas
perfidious	pérfido
bigotries	intolerancias
astonishingly	asombrosamente
valiantly	valientemente
clogs	zuecos
unease	malestar
panders	alcahuetes
troublingly	inquietantemente
infamy	infamia
foe	enemigo
shocking	chocante
clears	ocurre
disrespecting	irrespetando
glorify	glorificar
squabbling	disputas
suffering	sufrimiento
temptingly	tentadoramente
craziness	locura
swamped	inundado
contagious	contagioso
needy	necesitado
consistent	consistente
mist	niebla
debauchery	libertinaje
comfortably	cómodamente
antagonist	antagonista
breach	incumplimiento
thug	matón
displaced	desplazado
glib	elocuente
perplexing	confuso
disclaim	renunciar
tediously	tediosamente
scam	estafa
inconsequently	inconsecuentemente
crooks	ladrones
regrettably	lamentablemente
amenity	amenidad
hoax	engaño
mesmerizing	fascinante
swelled	engrosado
gaff	garfio
gorgeous	maravilloso
jagged	dentado
gruesome	horrible
smutty	tiznado
courageously	valientemente
unusable	inutilizable
razor-sharp	afilada
burns	quemaduras
enormously	enormemente
poor	pobre
messy	confuso
injury	lesión
diabolically	diabólicamente
hated	odiado
brutalities	brutalidades
restrict	restringir
fanatical	fanático
unsettled	inestable
courtly	cortés
exceedingly	excesivamente
heretic	hereje
offenses	delitos
lascivious	lascivo
brimstone	azufre
bloom	floración
cool	fresco
scrambled	revuelto
panicked	pánico
impugn	impugnar
struggles	luchas
savior	salvador
gaiety	alegría
deviate	desviarse
apprehensions	aprehensiones
triumphant	triunfal
stupidest	estúpida
bait	cebo
disoriented	desorientado
freezing	congelación
diabolic	diabólico
fortuitous	fortuito
powerful	potente
can't	no
skeptical	escéptico
whips	látigos
convience	conveniencia
ineffectiveness	inoperancia
motionless	inmóvil
drags	arrastra
hoodwink	engañar
overrated	sobrevalorado
undisputable	indiscutible
traumatic	traumático
weariness	cansancio
impeach	procesar
barbaric	bárbaro
empathize	empatizar
cheesy	caseoso
chastise	castigar
cheapen	abaratar
impose	prescribir
explosive	explosivo
eloquently	elocuentemente
elation	elación
restructure	reestructurar
lethargy	letargo
hallowed	santificado
coupists	golpistas
promised	prometido
grotesque	grotesco
spew	arrojar
bumped	topado
dissidents	disidentes
angelic	angelical
opinionated	dogmático
decrepitude	decrepitud
faultless	impecable
catastrophes	catástrofes
incompatability	incompatibilidad
heartfelt	cordial
decay	decadencia
gritty	arenoso
futile	fútil
soothe	calmar
mundane	mundano
embarrass	avergonzar
disparagingly	despectivamente
rash	erupción
overstatements	exageraciones
licentious	licencioso
paradoxically	paradójicamente
drought	sequía
unbiased	imparcial
provocative	provocativo
dispute	disputa
accusing	acusando
blaspheme	blasfemar
over-acted	sobre-actuado
wedge	cuña
apathetically	apatía
awfulness	horror
deadly	mortal
perverted	pervertido
lackadaisical	lánguido
impatient	impaciente
dead	muerto
concise	conciso
beneficiary	beneficiario
guilty	culpable
indefensible	indefendible
exultingly	exultantes
regard	respecto
accuse	acusar
interests	intereses
rampage	alboroto
aborts	aborta
scorn	desdén
profanity	blasfemia
excitingly	emocionante
more	más
despair	desesperación
hostility	hostilidad
enthralled	cautivados
crap	mierda
peeved	furioso
unuseably	inutilizable
puzzlement	perplejidad
crumpled	arrugado
snagged	enganchado
matte	mate
kindness	bondad
uproariously	ruidosamente
fierce	feroz
vile	vil
manipulative	manipulativo
deluge	diluvio
bland	soso
deceit	engaño
snobbish	snob
fictitious	ficticio
deject	presar
unwell	indispuesto
debilitate	debilitar
insultingly	insultantemente
nobly	noble
weakness	debilidad
nimble	ágil
subvert	subvertir
bulky	voluminoso
complements	complementos
glee	júbilo
languor	languidez
dents	abolladuras
wreck	naufragio
bruise	contusión
solace	solitud
absurdly	absurdamente
attacks	ataques
recklessly	imprudentemente
nauseating	nauseabundo
subsidize	subvencionar
pretty	bastante
steady	firme
expunge	borrar
overstates	exagera
tangled	enredado
bores	taladros
thorny	espinoso
overstated	exagerado
astound	asombrar
underdog	desvalido
allegations	alegaciones
righten	derecho
sourly	acritud
fault	culpa
desiccated	desecado
long-winded	prolijo
prattle	parloteo
difficult	difícil
comfy	confortable
startle	asustar
standout	destacado
excites	excita
cuteness	monería
harbors	puertos
debatable	discutible
proper	correcto
disgusted	disgustado
strident	estridente
apprehensively	aprensión
depress	deprimir
strangle	estrangular
nosey	fisgón
bunk	litera
exaggeration	exageración
turmoil	confusión
ameliorate	mejorar
innovative	innovador
unpopular	impopular
annoying	molesto
splatter	salpicadura
distastefully	desagrado
lean	magro
undermining	minando
disunity	desunión
advocate	defensor
opportunistic	oportunista
stuttered	tartamudeado
respectfully	respetuosamente
infiltrators	infiltrados
insidiously	insidiosamente
sensations	sensaciones
creepy	horripilante
unrivaled	incomparable
impress	impresionar
regally	regiamente
educated	educado
betray	traicionar
beneficial	sano
friendly	amistoso
stress	estrés
desultory	inconexo
harden	duro
cost-effective	rentable
dying	moribundo
interrupt	interrumpir
deform	deformar
licentiously	licenciosamente
noiseless	silencioso
lemon	limón
euphorically	eufóricamente
finer	finlandés
poetic	poético
hogs	cerdos
taut	tirante
lyrical	lírico
acrid	acre
lanky	larguirucho
imprisonment	encarcelamiento
meddlesome	entrometido
helpful	útil
repression	repressió
correct	correcto
cheery	alegre
burden	carga
defamation	difamación
garish	llamativo
ruffle	volante
imprecisely	imprecisa
extravagantly	extravagantemente
illumine	iluminar
picky	exigente
lies	mentiras
accurately	exacto
adamantly	inflexiblemente
revelation	revelación
bitingly	mordazmente
dispirited	desalentado
streamlined	aerodinámico
perfect	perfecto
arduously	arduamente
grouchy	malhumorado
onslaught	embate
appalling	espantoso
threaten	amenazar
litigious	litigioso
vivid	vívido
obscene	obsceno
uncomfy	incómoda
inconsiderately	desconsideradamente
objection	objeción
soundly	sólidamente
smells	olores
disallow	rechazar
goofy	mentecato
flaking	descamación
inordinately	desmesuradamente
jitters	nervios
unlucky	desafortunado
disturbed	perturbado
turbulent	turbulento
earnest	serio
rattle	sonajero
enraging	enfurecedora
bemused	confundido
improbably	improbablemente
disillusion	desilusión
lucrative	lucrativo
flatteringly	halagadoramente
rocky	rocoso
displeased	disgustado
ricer	arrocera
stylized	estilizado
forbidding	prohibiendo
adoring	cariñoso
abomination	abominación
unwise	imprudente
inglorious	ignominioso
discontented	descontento
accomodative	acomodativa
corrupted	corrompido
prickles	espinas
denied	negado
sour	agrio
mockeries	burlas
covetous	codicioso
insensitivity	insensibilidad
alarmingly	alarmantemente
nauseates	náuseas
capsize	zozobrar
complicit	complicita
wearisome	aburrido
abrasive	abrasivo
victory	victoria
stumped	sacado
fussy	quisquilloso
altruistic	altruista
patriotic	patriótico
toil	trabajo
loving	amoroso
defensive	defensiva
ill-favored	feo
snub	desaire
integral	exhaustivo
imprecise	impreciso
uncivilized	incivilizado
sickening	nauseabundo
worsen	exacerbar
scummy	espumoso
chatterbox	charlatán
exceeds	excede
revolutionize	revolucionar
bastards	bastardos
smudges	manchas
deviousness	desviación
ethical	ético
dejectedly	abatido
alarming	alarmante
hypocricy	hipocresía
celebrated	célebre
maneuverable	maniobrable
cumbersome	incómodo
slaves	esclavos
lawless	ilegal
ignoble	innoble
overdone	exagerado
protested	protestado
acclamation	aclamación
incompetently	incompetente
calumnies	calumnias
insidious	insidioso
amuse	divertir
discountenance	desaprobar
indignation	indignación
fascinate	fascinar
vehemently	vehementemente
relent	ablandarse
unravel	desvela
smooth	liso
sexy	atractivo
illogical	ilógico
ineffectual	ineficaz
eager	ansioso
remunerate	remunerar
heinous	atroz
worrier	angustiado
lucky	afortunado
infallibly	infaliblemente
violation	violación
wonderful	maravilloso
correctly	correctamente
bliss	felicidad
baffle	deflector
needlessly	innecesariamente
capable	capaz
marginally	ligeramente
obtuse	obtuso
disapointment	decepción
infections	infecciones
honoring	homenaje
wrestle	luchar
jaw-dropping	asombroso
racism	racismo
evildoer	malhechor
somber	sombrío
mushy	mollar
stridently	estridentemente
malodorous	maloliente
rifts	divisiones
unlimited	ilimitado
deservedly	merecidamente
dirt	suciedad
dignity	dignidad
couldn't	no
retarded	retardado
swanky	ostentoso
instigators	instigadores
stymied	obstaculizado
ploy	táctica
deceiver	engañador
deceive	engañar
pompous	pomposo
excessive	excesivo
implausibly	inverosímilmente
demise	fallecimiento
authoritarian	autoritario
apocalypse	apocalipsis
sever	cortar
chaste	casto
grainy	granoso
dissuasive	disuasivo
hedge	cobertura
resignation	renuncia
won	ganó
terrific	estupendo
lethal	letal
contaminated	contaminado
idiot	idiota
discredit	desacreditar
idealize	idealizar
appealing	atractivo
hobble	cojera
mangle	exprimidor
unclean	sucio
breakdown	desglose
untimely	inoportuno
blasphemous	blasfemo
heathen	pagano
gorgeously	magníficamente
fervent	ferviente
busts	bustos
inequality	desigualdad
doubt	duda
disturb	perturbar
incoherence	incoherencia
damnation	condenación
suppression	supresión
accurate	exacto
monumentally	monumentalmente
backwoods	rústico
flare	llamarada
mock	simulado
damnable	detestable
persecution	persecución
inescapable	inevitable
overtaken	superado
fortunately	afortunadamente
inviolate	inviolado
hassles	molestias
drag	arrastrar
irrecoverably	irrecuperable
irksome	molesto
weep	llorar
miserably	tristemente
dazzling	deslumbrante
unintelligible	ininteligible
calamitously	horriblemente
mists	nieblas
ignorant	ignorante
passionately	apasionadamente
direly	imperiosamente
confuses	confunde
peevish	malhumorado
immoral	inmoral
illegally	ilegalmente
itch	prurito
chasten	castigar
invalidity	invalidez
enliven	animar
stereotype	estereotipo
arrogantly	arrogantemente
warily	cautela
upbeat	optimista
tranquility	tranquilidad
affordably	asequible
world-famous	famosa
sting	picadura
lunatic	lunático
nervous	nervioso
gripe	queja
mighty	poderoso
trustworthiness	integridad
malady	enfermedad
needs	necesita
unsavory	desagradable
cleanliness	limpieza
tramp	vagabundo
squeak	chirrido
mistakenly	erróneamente
shambles	ruinas
rumple	arrugar
wreaked	causado
relish	saborear
butcher	carnicero
mystery	misterio
snagging	enganches
challenging	desafiante
dishonestly	deshonestamente
cherub	querubín
inexpertly	inexpertamente
insinuation	insinuación
amputate	amputar
impious	impío
pandemonium	pandemonio
obscured	oscurecido
loves	ama
portable	portátil
admonishment	amonestación
wieldy	manejable
denial	negación
horrifying	horripilante
invidious	injusto
pretty	bastante
lechery	lascivia
usurp	usurpar
sneer	burla
volatile	volátil
eagerly	ansiosamente
expropriate	expropiar
testy	irascible
dope	droga
rejuvenated	rejuvenecido
loved	amado
wrinkles	arrugas
vomiting	vómitos
skeletons	esqueletos
flirty	coqueta
iniquitous	inicuo
grudging	avaro
offensively	ofensivamente
openness	franqueza
interference	interferencia
gutter	canalón
dexterous	diestro
beseech	implorar
dehumanization	deshumanización
demonic	demoníaco
stinks	apesta
garbage	basura
annoyances	molestias
flees	huye
dissension	disensión
mortify	mortificar
blur	mancha
huckster	mercachifle
dissappointing	decepcionante
assassinate	asesinar
disorient	desorientar
shrew	musaraña
draconic	dracónica
impartiality	imparcialidad
shrouded	envuelto
scared	miedo
pains	esfuerzos
galls	agallas
betraying	traicionero
ambivalence	ambivalencia
guiltless	inocente
romanticize	romantizar
trump	triunfo
dogmatic	dogmático
exuberant	exuberante
recover	recuperar
detracted	detraído
bad	mal
haywire	loco
rabid	rabioso
spoon-feed	mimar
vent	respiradero
scathing	mordaz
criticism	crítica
amiability	amabilidad
undercutting	subvaloración
impartially	imparcialmente
superbly	magníficamente
delayed	retrasado
interruption	interrupción
stubbornly	tercamente
egregiously	notoriamente
frolic	fiesta
instantly	instantáneamente
trumpet	trompeta
frenzied	frenético
poverty	pobreza
slowly	despacio
creak	crujido
monstrous	monstruoso
denounce	denunciar
flake	escama
balanced	equilibrado
harmful	perjudicial
ludicrously	ridículamente
irregularity	irregularidad
warlike	belicoso
innocuous	inocuo
falls	caídas
extremist	extremista
dictator	dictador
torture	tortura
suitable	adecuado
impudent	impudente
state-of-the-art	puntera
undesirable	indeseable
precipitate	precipitar
terribly	terriblemente
gasp	grito
calm	calma
pleases	plazca
deadbeat	perezoso
upsetting	molesto
selfishness	egoísmo
heal	sanar
savagery	salvajismo
courteous	cortés
snags	inconvenientes
discouragement	desaliento
treasure	tesoro
achievable	alcanzable
humourous	chistoso
rectifying	rectificación
divisive	divisivo
refund	reembolso
lapses	lapsos
scream	grito
morbidly	mórbida
ruining	arruinando
neatly	pulcramente
risk	riesgo
reverently	reverentemente
irked	irritado
zap	zas
aggression	agresión
substantive	sustantivo
brittle	quebradizo
demonized	demonizado
leading	líder
understandable	comprensible
overwhelms	abruma
elite	élite
elegant	elegante
refusing	negándose
sincere	sincero
keen	humos
brilliance	brillantez
extol	ensalzar
good	buenos
irrationalities	irracionalidades
confront	criminal
significant	significativo
plaything	juguete
warning	advertencia
stainless	inoxidable
refusal	negativa
guidance	dirección
fatalistically	fatalistamente
recoil	retroceso
compliant	obediente
posturing	posturas
hardships	dificultades
loses	pierde
improperly	indebidamente
idolize	idolatrar
infringe	infringir
hissing	silbido
self-respect	dignidad
siege	cerco
awe	temor
unfeeling	insensible
strong	fuerte
twist	torcedura
devoid	vacío
grapple	luchar
shortage	escasez
vain	vano
hooligan	gamberro
senile	senil
trapped	atrapado
neat	ordenado
redundant	redundante
ruthless	implacable
rant	despotricar
inconsolably	inconsolablemente
aborted	abortado
convenient	conveniente
runaway	fugitivo
frighten	asustar
dumb	mudo
inveigle	seducir
maturity	madurez
unquestionable	incuestionable
appreciate	apreciar
agonizingly	agonizantemente
joy	alegría
disbeliever	incrédulo
overturn	volcar
numb	entumecido
picket	piquete
nag	rocín
conceited	presumido
pamper	mimar
boycott	boicoteo
cringe	encogerse
-	-
annoys	late
cleverly	inteligentemente
veritable	verdadero
weakening	debilitación
hassle	molestia
defunct	difunto
dissolute	disoluto
engulf	tragarse
beastly	bestial
loyalty	lealtad
cramped	estrecho
multi-purpose	multiuso
conscientious	concienzudo
healthful	sano
rhetorical	retórico
obsess	obsesionar
haunting	obsesionante
hating	odiando
inordinate	desordenado
aground	encallado
calamities	calamidades
enraptured	embelesado
traitor	traidor
vengeful	vengativo
denunciate	denunciar
tarnishing	deslustre
bowdlerize	expurgar
fun	diversión
defy	desafiar
overheat	sobrecalentar
immaterial	inmaterial
violator	violador
joyously	gozosamente
revive	reanimar
rightness	justicia
retractable	retráctil
intelligence	inteligencia
degrade	degradar
doddering	chocho
limits	límites
logical	lógico
lawlessness	desorden
infuriating	exasperante
compassionate	compasivo
doomed	condenado
unnecessary	innecesario
adulate	adular
stains	manchas
healthy	saludable
authoritative	autorizado
tortures	torturas
tortuous	tortuoso
happiness	felicidad
wicked	malvado
chastisement	castigo
prudence	prudencia
austere	austero
pathetic	patético
villainous	villano
infidels	infieles
gaily	alegremente
misunderstanding	malentendido
misunderstandings	malentendidos
absurd	absurdo
furiously	furiosamente
bore	taladro
carelessness	descuido
exhausted	agotado
criticize	criticar
draining	drenaje
apologists	apologistas
harassed	acosado
shortsighted	miope
cutthroat	asesino
lacks	carece
kindly	amablemente
heartbreakingly	desgarradoramente
exile	exilio
worrisome	inquietante
womanizing	mujeriego
incessantly	incesantemente
denying	negando
accusations	acusaciones
trusting	confianza
vicious	vicioso
refreshed	refrescado
indecency	indecencia
reforming	reformando
playful	juguetón
forgetfulness	olvido
torment	tormento
repulse	repulsión
disaffect	desafectar
arbitrary	arbitrario
banalize	vulgarizar
obscurity	oscuridad
mortification	mortificación
unjustly	injustamente
insufficiently	insuficientemente
appallingly	horriblemente
flaunt	ostentar
distorted	distorsionado
revere	reverenciar
gross	bruto
agonies	agonías
grievously	gravemente
suicidal	suicida
stab	puñalada
adversity	adversidad
groundless	infundado
commendably	encomiable
elevate	elevar
passiveness	pasividad
undercut	socavada
ill-mannered	maleducado
disapproval	desaprobación
inflammatory	inflamatorio
sobering	aleccionadora
irreconcilable	irreconciliable
occluding	oclusión
decayed	deteriorado
ugliness	fealdad
indiscriminate	indistinto
cold	frío
frustration	frustración
precise	preciso
stuttering	tartamudeo
shocked	conmocionado
sweetly	dulcemente
phenomenal	fenomenal
mudslinging	vilipendio
hero	héroe
splitting	división
remission	remisión
overthrows	derrocamientos
unsuspecting	desprevenido
resourcefulness	inventiva
abusive	abusivo
farce	farsa
immoderate	inmoderado
clamorous	clamoroso
object	objeto
gaining	negociación
baseless	infundado
diplomatic	diplomático
revile	injuriar
madder	rubia
pandering	proxenetismo
gainfully	remunerado
shake	sacudir
hindrance	obstáculo
scornfully	desdeñosamente
straggle	rezagarse
prejudge	prejuzgar
fulfillment	cumplimiento
intelligible	inteligible
perturb	perturbar
iniquity	iniquidad
rapport	compenetración
clunky	torpe
repel	repeler
bankrupt	quebrado
evaluative	evaluativo
poky	diminuto
flighty	frívolo
infringement	infracción
luster	lustre
contrive	idear
agility	agilidad
admonisher	amonestador
eminence	eminencia
partisans	partidarios
enjoyment	disfrute
unjust	injusto
destitute	indigente
pointless	inútil
replaceable	reemplazable
decry	censurar
jollify	alegrar
blameworthy	censurable
touchy	quisquilloso
glum	sombrío
diatribe	diatriba
feverish	febril
biases	sesgos
intimacy	intimidad
shriek	chillido
apologist	apologista
indecent	indecente
recant	retractar
cripples	lisiados
insignificance	insignificancia
hothead	exaltado
rants	rantes
lead	conducir
volatility	volatilidad
demon	demonio
thriving	próspera
trash	basura
bump	chichón
diligent	diligente
entrapment	atrapamiento
alienate	enajenar
unfounded	infundado
atrocities	atrocidades
counterproductive	contraproducente
forfeit	perder
drippy	pegajosa
incompatibility	incompatibilidad
invalidate	invalidar
instability	inestabilidad
relief	alivio
